##############################################
#F#                #        # #            # #
# #   ####### #   ## ###### # # ##### ###### #
# #   #       #  ##  #    #     #   # #    # #
# #   # #######     ## # ########            #
# ####  #     ### #### #          ########## #
#       #   #       ## # ########          #S#
##############################################